{
    "mapName": "my-neighbourhood/A4/neighbourhood-A4",
    "tileSet": "my_neighbourhood",
    "outdoors": true,
    "music": "game-jam.mp3",
    "neighbours": {
        "left": "my-neighbourhood/A3/neighbourhood-A3"
    },
    "rows":11,
    "columns":23,
    "grid": [
        [335,352,353,354,355,393,393,397,396,389,390,390,390,390,390,417,418,17,17,17,202,224,224,224],
        [339,356,357,358,359,380,393,393,396,394,395,404,405,406,407,408,12,17,17,17,169,160,224,224],
        [343,360,361,362,363,370,371,369,396,398,399,399,409,410,411,408,17,17,25,17,187,224,224,224],
        [347,364,365,366,367,374,375,373,400,402,403,403,403,414,415,416,83,17,17,17,206,160,224,224],
        [245,309,255,287,254,19,17,17,17,17,17,17,19,25,17,17,17,21,17,25,187,70,224,224],
        [245,245,286,253,254,17,17,17,17,17,17,17,17,17,18,25,18,17,17,17,187,224,224,224],
        [253,245,245,245,254,17,17,17,368,17,64,17,17,21,22,368,22,21,17,17,187,224,224,224],
        [245,305,261,262,258,17,17,17,17,17,17,66,17,17,19,17,26,25,115,108,187,160,224,224],
        [265,265,265,265,265,4,4,4,4,4,4,4,4,4,4,4,4,4,4,4,205,224,224,224],
        [224,224,7,224,224,224,7,224,224,224,32,33,34,224,224,224,7,74,75,75,71,224,224,224],
        [224,224,23,23,224,23,28,23,23,23,23,23,23,23,23,23,23,23,23,23,28,224,224,224],
        [224,23,23,23,224,23,23,23,23,23,23,23,23,28,23,23,23,23,23,23,70,224,224,224]
    ],
    "doors": [ 
        {
            "row": 3, 
            "col": 14,
            "to"  : "my-neighbourhood/A4/yum-mart",
            "directionIn": "FACING_UP",
            "directionOut": "FACING_DOWN",
            "locked": false
        },
        {
            "row": 3, 
            "col": 2,
            "to"  : "my-neighbourhood/A4/luxury-house",
            "directionIn": "FACING_UP",
            "directionOut": "FACING_DOWN",
            "locked": false
        }
    ]
}

