{
    "mapName": "my-neighbourhood/my-neighbourhood",
    "tileSet": "my-neighbourhood",
    "src": "my-neighbourhood.png",
    "location": "oudoors",
    "uniqueTiles":47,
    "columns": 23,
    "rows": 9,
    "grid": [ 
      [ 24, 23, 23, 31, 40, 40, 40, 40, 40, 40, 40, 41, 31, 40, 40, 40, 40, 40, 40, 40, 41, 41, 40, 40, 40 ],
      [ 24, 23, 23, 31, 40, 40, 40, 40, 40, 40, 40, 41, 31, 40, 40, 40, 40, 40, 40, 40, 41, 41, 40, 40, 40 ],
      [ 24, 23, 23, 34, 37, 36, 37, 36, 44, 36, 37, 42, 34, 37, 36, 37, 36, 44, 36, 37, 42, 42, 37, 37, 37 ],
      [ 24, 23, 23, 35, 43, 43, 43, 43, 45, 43, 43, 43, 35, 43, 43, 43, 43, 45, 43, 43, 43, 43, 43, 43, 43 ],
      [ 24, 23, 23, 23, 23, 23, 23, 23, 23, 23, 23, 23, 23, 23, 23, 23, 23, 23, 23, 23, 23, 23, 23, 23, 23 ],
      [ 24, 23, 23, 23, 23, 23, 23, 23, 23, 23, 23, 23, 23, 23, 23, 23, 23, 23, 23, 23, 23, 23, 23, 23, 23 ],
      [ 24, 23, 23, 23, 23, 23, 23, 23, 23, 23, 23, 23, 23, 23, 23, 23, 23, 23, 23, 23, 23, 23, 23, 23, 23 ],
      [ 25, 26, 26, 26, 26, 26, 26, 26, 26, 26, 26, 26, 26, 26, 26, 26, 26, 26, 26, 26, 26, 26, 26, 26, 26 ],
      [  0,  2,  2,  2,  2,  2,  2,  2,  2,  2,  2,  2,  2,  2,  2,  2,  2,  2,  2,  2,  2,  2,  2,  2,  2 ],
      [  0,  2,  2,  2,  2,  2,  2,  2,  2,  2,  2,  2,  2,  2,  2,  2,  2,  2,  2,  2,  2,  2,  2,  2,  2 ]
    ],
    "blocked": [
        20, 21, 22, 32, 33, 34, 35,
        36, 37, 38, 39, 40, 41, 42,
        43
    ],
    "doors": [ 
        {
            "row": 2, 
            "col": 8,
            "to"  : "my-neighbourhood/my-house",
            "directionIn": "FACING_UP",
            "directionOut": "FACING_DOWN",
            "locked": false
        }
    ],
    "actions" : [
        {
            "row": 2,
            "col": 6,
            "type": "TEXT",
            "direction": "FACING_UP",
            "text": "What a dump, there's junk everywhere!"
        }
    ]
}