{
    "mapName": "my-neighbourhood/my-neighbourhood",
    "tileSet": "my-neighbourhood",
    "src": "my-neighbourhood.png",
    "location": "indoors",
    "uniqueTiles": 45,
    "columns": 73,
    "rows": 35,
    "grid": [
        [  0,  2,  2,  2,  2,  2,  2,  2,  2,  2,  2,  2,  2,  2,  5,  2,  2,  2,  2,  
           0,  2,  2,  2,  2,  2,  2,  2,  2,  2,  2,  2,  2,  2,  5,  2,  2,  2,  2,
           0,  2,  2,  2,  2,  2,  2,  2,  2,  2,  2,  2,  2,  2,  5,  2,  2,  2,  2,  
           0,  2,  2,  2,  2,  2,  2,  2,  2,  2,  2,  2,  2,  2,  5,  2,  2,  2,  2 ],
        [  1,  2,  2, 13, 14, 14, 14, 14, 14, 14, 14, 15,  2,  3,  6,  2,  2,  2,  2,
           1,  2,  2, 13, 14, 14, 14, 14, 14, 14, 14, 15,  2,  3,  6,  2,  2,  2,  2,
           1,  2,  2, 13, 14, 14, 14, 14, 14, 14, 14, 15,  2,  3,  6,  2,  2,  2,  2,
           1,  2,  2, 13, 14, 14, 14, 14, 14, 14, 14, 15,  2,  3,  6,  2,  2,  2,  2 ],
        [  0,  4,  2, 16, 17, 17, 17, 17, 17, 17, 17, 18,  2,  4,  5,  2,  2,  2,  2,
           0,  4,  2, 16, 17, 17, 17, 17, 17, 17, 17, 18,  2,  4,  5,  2,  2,  2,  2,
           0,  4,  2, 16, 17, 17, 17, 17, 17, 17, 17, 18,  2,  4,  5,  2,  2,  2,  2,
           0,  4,  2, 16, 17, 17, 17, 17, 17, 17, 17, 18,  2,  4,  5,  2,  2,  2,  2  ],
        [  1,  2,  2, 19, 20, 20, 20, 20, 20, 20, 20, 21,  2,  2,  6,  2,  2,  2,  2,
           1,  2,  2, 19, 20, 20, 20, 20, 20, 20, 20, 21,  2,  2,  6,  2,  2,  2,  2,
           1,  2,  2, 19, 20, 20, 20, 20, 20, 20, 20, 21,  2,  2,  6,  2,  2,  2,  2,
           1,  2,  2, 19, 20, 20, 20, 20, 20, 20, 20, 21,  2,  2,  6,  2,  2,  2,  2  ],
        [ 22, 23, 23, 31, 32, 32, 32, 32, 32, 32, 32, 33, 30, 30, 29,  7,  8,  7,  8,
          22, 23, 23, 31, 32, 32, 32, 32, 32, 32, 32, 33, 30, 30, 29,  7,  8,  7,  8,
          22, 23, 23, 31, 32, 32, 32, 32, 32, 32, 32, 33, 30, 30, 29,  7,  8,  7,  8,
          22, 23, 23, 31, 32, 32, 32, 32, 32, 32, 32, 33, 30, 30, 29,  7,  8,  7,  8 ],
        [ 24, 23, 23, 34, 37, 36, 37, 36, 36, 36, 37, 38, 23, 23, 28,  2,  9, 10,  2,
          24, 23, 23, 34, 37, 36, 37, 36, 36, 36, 37, 38, 23, 23, 28,  2,  9, 10,  2,
          24, 23, 23, 34, 37, 36, 37, 36, 36, 36, 37, 38, 23, 23, 28,  2,  9, 10,  2,
          24, 23, 23, 34, 37, 36, 37, 36, 36, 36, 37, 38, 23, 23, 28,  2,  9, 10,  2  ],
        [ 24, 23, 23, 34, 36, 36, 36, 36, 36, 36, 36, 39, 23, 23, 28,  2,  2,  2,  2,
          24, 23, 23, 34, 36, 36, 36, 36, 36, 36, 36, 39, 23, 23, 28,  2,  2,  2,  2,
          24, 23, 23, 34, 36, 36, 36, 36, 36, 36, 36, 39, 23, 23, 28,  2,  2,  2,  2,
          24, 23, 23, 34, 36, 36, 36, 36, 36, 36, 36, 39, 23, 23, 28,  2,  2,  2,  2 ],
        [ 24, 23, 23, 31, 40, 40, 40, 40, 40, 40, 40, 41, 23, 23, 28,  2,  9, 10,  2,
          24, 23, 23, 31, 40, 40, 40, 40, 40, 40, 40, 41, 23, 23, 28,  2,  9, 10,  2,
          24, 23, 23, 31, 40, 40, 40, 40, 40, 40, 40, 41, 23, 23, 28,  2,  9, 10,  2,
          24, 23, 23, 31, 40, 40, 40, 40, 40, 40, 40, 41, 23, 23, 28,  2,  9, 10,  2 ],
        [ 24, 23, 23, 34, 37, 36, 37, 36, 44, 36, 37, 38, 23, 23, 28,  2,  2,  2,  2,
          24, 23, 23, 34, 37, 36, 37, 36, 44, 36, 37, 38, 23, 23, 28,  2,  2,  2,  2,
          24, 23, 23, 34, 37, 36, 37, 36, 44, 36, 37, 38, 23, 23, 28,  2,  2,  2,  2,
          24, 23, 23, 34, 37, 36, 37, 36, 44, 36, 37, 38, 23, 23, 28,  2,  2,  2,  2 ],
        [ 24, 23, 23, 35, 43, 43, 43, 43, 45, 43, 43, 43, 23, 23, 28,  2,  9, 10,  2,
          24, 23, 23, 35, 43, 43, 43, 43, 45, 43, 43, 43, 23, 23, 28,  2,  9, 10,  2,
          24, 23, 23, 35, 43, 43, 43, 43, 45, 43, 43, 43, 23, 23, 28,  2,  9, 10,  2,
          24, 23, 23, 35, 43, 43, 43, 43, 45, 43, 43, 43, 23, 23, 28,  2,  9, 10,  2 ],
        [ 24, 23, 23, 23, 23, 23, 23, 23, 23, 23, 23, 23, 23, 23, 28,  2,  2,  2,  2, 
          24, 23, 23, 23, 23, 23, 23, 23, 23, 23, 23, 23, 23, 23, 28,  2,  2,  2,  2,
          24, 23, 23, 23, 23, 23, 23, 23, 23, 23, 23, 23, 23, 23, 28,  2,  2,  2,  2, 
          24, 23, 23, 23, 23, 23, 23, 23, 23, 23, 23, 23, 23, 23, 28,  2,  2,  2,  2 ],
        [ 24, 23, 23, 23, 23, 23, 23, 23, 23, 23, 23, 23, 23, 23, 28,  2,  9, 10,  2,
          24, 23, 23, 23, 23, 23, 23, 23, 23, 23, 23, 23, 23, 23, 28,  2,  9, 10,  2,
          24, 23, 23, 23, 23, 23, 23, 23, 23, 23, 23, 23, 23, 23, 28,  2,  9, 10,  2,
          24, 23, 23, 23, 23, 23, 23, 23, 23, 23, 23, 23, 23, 23, 28,  2,  9, 10,  2  ],
        [ 25, 26, 26, 26, 26, 26, 26, 26, 26, 26, 26, 26, 26, 26, 27, 11, 12, 11, 12, 
          25, 26, 26, 26, 26, 26, 26, 26, 26, 26, 26, 26, 26, 26, 27, 11, 12, 11, 12,
          25, 26, 26, 26, 26, 26, 26, 26, 26, 26, 26, 26, 26, 26, 27, 11, 12, 11, 12, 
          25, 26, 26, 26, 26, 26, 26, 26, 26, 26, 26, 26, 26, 26, 27, 11, 12, 11, 12 ],
          [  0,  2,  2,  2,  2,  2,  2,  2,  2,  2,  2,  2,  2,  2,  5,  2,  2,  2,  2,  
            0,  2,  2,  2,  2,  2,  2,  2,  2,  2,  2,  2,  2,  2,  5,  2,  2,  2,  2,
            0,  2,  2,  2,  2,  2,  2,  2,  2,  2,  2,  2,  2,  2,  5,  2,  2,  2,  2,  
            0,  2,  2,  2,  2,  2,  2,  2,  2,  2,  2,  2,  2,  2,  5,  2,  2,  2,  2 ],
         [  1,  2,  2, 13, 14, 14, 14, 14, 14, 14, 14, 15,  2,  3,  6,  2,  2,  2,  2,
            1,  2,  2, 13, 14, 14, 14, 14, 14, 14, 14, 15,  2,  3,  6,  2,  2,  2,  2,
            1,  2,  2, 13, 14, 14, 14, 14, 14, 14, 14, 15,  2,  3,  6,  2,  2,  2,  2,
            1,  2,  2, 13, 14, 14, 14, 14, 14, 14, 14, 15,  2,  3,  6,  2,  2,  2,  2 ],
         [  0,  4,  2, 16, 17, 17, 17, 17, 17, 17, 17, 18,  2,  4,  5,  2,  2,  2,  2,
            0,  4,  2, 16, 17, 17, 17, 17, 17, 17, 17, 18,  2,  4,  5,  2,  2,  2,  2,
            0,  4,  2, 16, 17, 17, 17, 17, 17, 17, 17, 18,  2,  4,  5,  2,  2,  2,  2,
            0,  4,  2, 16, 17, 17, 17, 17, 17, 17, 17, 18,  2,  4,  5,  2,  2,  2,  2  ],
         [  1,  2,  2, 19, 20, 20, 20, 20, 20, 20, 20, 21,  2,  2,  6,  2,  2,  2,  2,
            1,  2,  2, 19, 20, 20, 20, 20, 20, 20, 20, 21,  2,  2,  6,  2,  2,  2,  2,
            1,  2,  2, 19, 20, 20, 20, 20, 20, 20, 20, 21,  2,  2,  6,  2,  2,  2,  2,
            1,  2,  2, 19, 20, 20, 20, 20, 20, 20, 20, 21,  2,  2,  6,  2,  2,  2,  2  ],
         [ 22, 23, 23, 31, 32, 32, 32, 32, 32, 32, 32, 33, 30, 30, 29,  7,  8,  7,  8,
           22, 23, 23, 31, 32, 32, 32, 32, 32, 32, 32, 33, 30, 30, 29,  7,  8,  7,  8,
           22, 23, 23, 31, 32, 32, 32, 32, 32, 32, 32, 33, 30, 30, 29,  7,  8,  7,  8,
           22, 23, 23, 31, 32, 32, 32, 32, 32, 32, 32, 33, 30, 30, 29,  7,  8,  7,  8 ],
         [ 24, 23, 23, 34, 37, 36, 37, 36, 36, 36, 37, 38, 23, 23, 28,  2,  9, 10,  2,
           24, 23, 23, 34, 37, 36, 37, 36, 36, 36, 37, 38, 23, 23, 28,  2,  9, 10,  2,
           24, 23, 23, 34, 37, 36, 37, 36, 36, 36, 37, 38, 23, 23, 28,  2,  9, 10,  2,
           24, 23, 23, 34, 37, 36, 37, 36, 36, 36, 37, 38, 23, 23, 28,  2,  9, 10,  2  ],
         [ 24, 23, 23, 34, 36, 36, 36, 36, 36, 36, 36, 39, 23, 23, 28,  2,  2,  2,  2,
           24, 23, 23, 34, 36, 36, 36, 36, 36, 36, 36, 39, 23, 23, 28,  2,  2,  2,  2,
           24, 23, 23, 34, 36, 36, 36, 36, 36, 36, 36, 39, 23, 23, 28,  2,  2,  2,  2,
           24, 23, 23, 34, 36, 36, 36, 36, 36, 36, 36, 39, 23, 23, 28,  2,  2,  2,  2 ],
         [ 24, 23, 23, 31, 40, 40, 40, 40, 40, 40, 40, 41, 23, 23, 28,  2,  9, 10,  2,
           24, 23, 23, 31, 40, 40, 40, 40, 40, 40, 40, 41, 23, 23, 28,  2,  9, 10,  2,
           24, 23, 23, 31, 40, 40, 40, 40, 40, 40, 40, 41, 23, 23, 28,  2,  9, 10,  2,
           24, 23, 23, 31, 40, 40, 40, 40, 40, 40, 40, 41, 23, 23, 28,  2,  9, 10,  2 ],
         [ 24, 23, 23, 34, 37, 36, 37, 36, 44, 36, 37, 38, 23, 23, 28,  2,  2,  2,  2,
           24, 23, 23, 34, 37, 36, 37, 36, 44, 36, 37, 38, 23, 23, 28,  2,  2,  2,  2,
           24, 23, 23, 34, 37, 36, 37, 36, 44, 36, 37, 38, 23, 23, 28,  2,  2,  2,  2,
           24, 23, 23, 34, 37, 36, 37, 36, 44, 36, 37, 38, 23, 23, 28,  2,  2,  2,  2 ],
         [ 24, 23, 23, 35, 43, 43, 43, 43, 45, 43, 43, 43, 23, 23, 28,  2,  9, 10,  2,
           24, 23, 23, 35, 43, 43, 43, 43, 45, 43, 43, 43, 23, 23, 28,  2,  9, 10,  2,
           24, 23, 23, 35, 43, 43, 43, 43, 45, 43, 43, 43, 23, 23, 28,  2,  9, 10,  2,
           24, 23, 23, 35, 43, 43, 43, 43, 45, 43, 43, 43, 23, 23, 28,  2,  9, 10,  2 ],
         [ 24, 23, 23, 23, 23, 23, 23, 23, 23, 23, 23, 23, 23, 23, 28,  2,  2,  2,  2, 
           24, 23, 23, 23, 23, 23, 23, 23, 23, 23, 23, 23, 23, 23, 28,  2,  2,  2,  2,
           24, 23, 23, 23, 23, 23, 23, 23, 23, 23, 23, 23, 23, 23, 28,  2,  2,  2,  2, 
           24, 23, 23, 23, 23, 23, 23, 23, 23, 23, 23, 23, 23, 23, 28,  2,  2,  2,  2 ],
         [ 24, 23, 23, 23, 23, 23, 23, 23, 23, 23, 23, 23, 23, 23, 28,  2,  9, 10,  2,
           24, 23, 23, 23, 23, 23, 23, 23, 23, 23, 23, 23, 23, 23, 28,  2,  9, 10,  2,
           24, 23, 23, 23, 23, 23, 23, 23, 23, 23, 23, 23, 23, 23, 28,  2,  9, 10,  2,
           24, 23, 23, 23, 23, 23, 23, 23, 23, 23, 23, 23, 23, 23, 28,  2,  9, 10,  2  ],
         [ 25, 26, 26, 26, 26, 26, 26, 26, 26, 26, 26, 26, 26, 26, 27, 11, 12, 11, 12, 
           25, 26, 26, 26, 26, 26, 26, 26, 26, 26, 26, 26, 26, 26, 27, 11, 12, 11, 12,
           25, 26, 26, 26, 26, 26, 26, 26, 26, 26, 26, 26, 26, 26, 27, 11, 12, 11, 12, 
           25, 26, 26, 26, 26, 26, 26, 26, 26, 26, 26, 26, 26, 26, 27, 11, 12, 11, 12 ],
           [  0,  2,  2,  2,  2,  2,  2,  2,  2,  2,  2,  2,  2,  2,  5,  2,  2,  2,  2,  
            0,  2,  2,  2,  2,  2,  2,  2,  2,  2,  2,  2,  2,  2,  5,  2,  2,  2,  2,
            0,  2,  2,  2,  2,  2,  2,  2,  2,  2,  2,  2,  2,  2,  5,  2,  2,  2,  2,  
            0,  2,  2,  2,  2,  2,  2,  2,  2,  2,  2,  2,  2,  2,  5,  2,  2,  2,  2 ],
         [  1,  2,  2, 13, 14, 14, 14, 14, 14, 14, 14, 15,  2,  3,  6,  2,  2,  2,  2,
            1,  2,  2, 13, 14, 14, 14, 14, 14, 14, 14, 15,  2,  3,  6,  2,  2,  2,  2,
            1,  2,  2, 13, 14, 14, 14, 14, 14, 14, 14, 15,  2,  3,  6,  2,  2,  2,  2,
            1,  2,  2, 13, 14, 14, 14, 14, 14, 14, 14, 15,  2,  3,  6,  2,  2,  2,  2 ],
         [  0,  4,  2, 16, 17, 17, 17, 17, 17, 17, 17, 18,  2,  4,  5,  2,  2,  2,  2,
            0,  4,  2, 16, 17, 17, 17, 17, 17, 17, 17, 18,  2,  4,  5,  2,  2,  2,  2,
            0,  4,  2, 16, 17, 17, 17, 17, 17, 17, 17, 18,  2,  4,  5,  2,  2,  2,  2,
            0,  4,  2, 16, 17, 17, 17, 17, 17, 17, 17, 18,  2,  4,  5,  2,  2,  2,  2  ],
         [  1,  2,  2, 19, 20, 20, 20, 20, 20, 20, 20, 21,  2,  2,  6,  2,  2,  2,  2,
            1,  2,  2, 19, 20, 20, 20, 20, 20, 20, 20, 21,  2,  2,  6,  2,  2,  2,  2,
            1,  2,  2, 19, 20, 20, 20, 20, 20, 20, 20, 21,  2,  2,  6,  2,  2,  2,  2,
            1,  2,  2, 19, 20, 20, 20, 20, 20, 20, 20, 21,  2,  2,  6,  2,  2,  2,  2  ],
         [ 22, 23, 23, 31, 32, 32, 32, 32, 32, 32, 32, 33, 30, 30, 29,  7,  8,  7,  8,
           22, 23, 23, 31, 32, 32, 32, 32, 32, 32, 32, 33, 30, 30, 29,  7,  8,  7,  8,
           22, 23, 23, 31, 32, 32, 32, 32, 32, 32, 32, 33, 30, 30, 29,  7,  8,  7,  8,
           22, 23, 23, 31, 32, 32, 32, 32, 32, 32, 32, 33, 30, 30, 29,  7,  8,  7,  8 ],
         [ 24, 23, 23, 34, 37, 36, 37, 36, 36, 36, 37, 38, 23, 23, 28,  2,  9, 10,  2,
           24, 23, 23, 34, 37, 36, 37, 36, 36, 36, 37, 38, 23, 23, 28,  2,  9, 10,  2,
           24, 23, 23, 34, 37, 36, 37, 36, 36, 36, 37, 38, 23, 23, 28,  2,  9, 10,  2,
           24, 23, 23, 34, 37, 36, 37, 36, 36, 36, 37, 38, 23, 23, 28,  2,  9, 10,  2  ],
         [ 24, 23, 23, 34, 36, 36, 36, 36, 36, 36, 36, 39, 23, 23, 28,  2,  2,  2,  2,
           24, 23, 23, 34, 36, 36, 36, 36, 36, 36, 36, 39, 23, 23, 28,  2,  2,  2,  2,
           24, 23, 23, 34, 36, 36, 36, 36, 36, 36, 36, 39, 23, 23, 28,  2,  2,  2,  2,
           24, 23, 23, 34, 36, 36, 36, 36, 36, 36, 36, 39, 23, 23, 28,  2,  2,  2,  2 ],
         [ 24, 23, 23, 31, 40, 40, 40, 40, 40, 40, 40, 41, 23, 23, 28,  2,  9, 10,  2,
           24, 23, 23, 31, 40, 40, 40, 40, 40, 40, 40, 41, 23, 23, 28,  2,  9, 10,  2,
           24, 23, 23, 31, 40, 40, 40, 40, 40, 40, 40, 41, 23, 23, 28,  2,  9, 10,  2,
           24, 23, 23, 31, 40, 40, 40, 40, 40, 40, 40, 41, 23, 23, 28,  2,  9, 10,  2 ],
         [ 24, 23, 23, 34, 37, 36, 37, 36, 44, 36, 37, 38, 23, 23, 28,  2,  2,  2,  2,
           24, 23, 23, 34, 37, 36, 37, 36, 44, 36, 37, 38, 23, 23, 28,  2,  2,  2,  2,
           24, 23, 23, 34, 37, 36, 37, 36, 44, 36, 37, 38, 23, 23, 28,  2,  2,  2,  2,
           24, 23, 23, 34, 37, 36, 37, 36, 44, 36, 37, 38, 23, 23, 28,  2,  2,  2,  2 ],
         [ 24, 23, 23, 35, 43, 43, 43, 43, 45, 43, 43, 43, 23, 23, 28,  2,  9, 10,  2,
           24, 23, 23, 35, 43, 43, 43, 43, 45, 43, 43, 43, 23, 23, 28,  2,  9, 10,  2,
           24, 23, 23, 35, 43, 43, 43, 43, 45, 43, 43, 43, 23, 23, 28,  2,  9, 10,  2,
           24, 23, 23, 35, 43, 43, 43, 43, 45, 43, 43, 43, 23, 23, 28,  2,  9, 10,  2 ],
         [ 24, 23, 23, 23, 23, 23, 23, 23, 23, 23, 23, 23, 23, 23, 28,  2,  2,  2,  2, 
           24, 23, 23, 23, 23, 23, 23, 23, 23, 23, 23, 23, 23, 23, 28,  2,  2,  2,  2,
           24, 23, 23, 23, 23, 23, 23, 23, 23, 23, 23, 23, 23, 23, 28,  2,  2,  2,  2, 
           24, 23, 23, 23, 23, 23, 23, 23, 23, 23, 23, 23, 23, 23, 28,  2,  2,  2,  2 ],
         [ 24, 23, 23, 23, 23, 23, 23, 23, 23, 23, 23, 23, 23, 23, 28,  2,  9, 10,  2,
           24, 23, 23, 23, 23, 23, 23, 23, 23, 23, 23, 23, 23, 23, 28,  2,  9, 10,  2,
           24, 23, 23, 23, 23, 23, 23, 23, 23, 23, 23, 23, 23, 23, 28,  2,  9, 10,  2,
           24, 23, 23, 23, 23, 23, 23, 23, 23, 23, 23, 23, 23, 23, 28,  2,  9, 10,  2  ],
         [ 25, 26, 26, 26, 26, 26, 26, 26, 26, 26, 26, 26, 26, 26, 27, 11, 12, 11, 12, 
           25, 26, 26, 26, 26, 26, 26, 26, 26, 26, 26, 26, 26, 26, 27, 11, 12, 11, 12,
           25, 26, 26, 26, 26, 26, 26, 26, 26, 26, 26, 26, 26, 26, 27, 11, 12, 11, 12, 
           25, 26, 26, 26, 26, 26, 26, 26, 26, 26, 26, 26, 26, 26, 27, 11, 12, 11, 12 ]

    ],
    "blocked": [
        20, 21, 22, 32, 33, 34, 35,
        36, 37, 38, 39, 40, 41, 42,
        43
    ],
    "doors": [ 
        {
            "row": 9, 
            "col": 8,
            "to"  : "my-neighbourhood/my-house",
            "directionIn": "FACING_UP",
            "directionOut": "FACING_DOWN",
            "locked": false
        }
    ],
    "actions" : [
        {
            "row": 9,
            "col": 6,
            "type": "TEXT",
            "direction": "FACING_UP",
            "text": "What a dump, there's junk everywhere!"
        }
    ]
}