{    
    "mapName": "my-neighbourhood/neighbourhood-A3",
    "tileSet": "neighbourhood-A3",
    "src": "city1big_tiles.png",
    "outdoors": true,
    "music": "game-jam.mp3",
    "neighbours": {
        "left": "my-neighbourhood/neighbourhood-A2",
        "right": "my-neighbourhood/neighbourhood-A4"
    },
    "uniqueTiles": 519,
    "columns": 23,
    "rows": 9,
    "grid": [
        [30,31,32,33,34,35,36,37,38,39,40,41,41,41,42,43,44,44,44,44,44,45,46,46],
        [93,94,95,96,97,98,99,100,101,102,103,"E","E","E",104,105,106,107,108,109,110,111,112,113],
        [309,309,184,185,186,187,188,189,190,191,192,193,194,195,196,197,198,199,200,201,202,203,204,205],
        [309,309,309,270,282,272,273,274,275,276,277,278,278,278,279,280,282,281,282,283,284,285,286,287],
        [309,309,309,328,329,35,330,331,332,333,334,35,332,35,332,35,332,35,332,35,332,35,332,35],
        [309,309,309,270,282,281,282,281,282,281,359,360,282,361,362,363,364,281,282,281,282,281,282,281],
        [309,309,396,397,398,35,332,35,332,35,332,35,399,400,401,402,332,403,332,35,332,404,405,35],
        [309,309,309,433,434,441,"E","E","E","E",441,440,435,436,"E","E","E",437,"E","E","E",438,439, 439],
        [309,309,309,480,481,309,309,309,309,309,482,309,309,483,484,485,486,309,309,309,487,309,500,309],
        [309,509,309,309,309,309,309,309,309,510,309,309,511,309,309,309,309,309,309,309,309,309,309,309]
    ]
}