{
    "mapName": "my-neighbourhood/neighbourhood-A0",
    "tileSet": "neighbourhood-A2",
    "src": "city1big_tiles.png",
    "outdoors": true,
    "music": "game-jam.mp3",
    "neighbours": {
        "right": "my-neighbourhood/neighbourhood-A1"
    },
    "rows": 15,
    "columns": 23,
    "grid": [
        [4,5,4,5,4,5,4,5,105,105,105,105,105,105,105,18,20,21,21,21,21,21,21,21],
        [31,14,31,14,31,14,31,14,105,101,102,102,102,103,105,51,50,49,50,49,50,49,50,49],
        [69,70,69,70,69,70,69,70,105,140,141,141,141,142,105,18,100,95,100,95,100,95,100,95],
        [116,117,116,117,116,117,116,117,105,105,105,105,105,105,105,18,100,100,100,100,100,100,100,56],
        [126,126,125,125,125,125,23,63,105,105,105,96,97,97,98,99,100,101,103,144,101,103,104,105],
        [145,145,125,125,125,125,23,63,132,134,134,135,136,136,137,138,100,140,142,144,140,142,143,139],
        [126,126,125,125,186,187,23,23,196,193,193,193,193,197,175,176,208,208,145,147,145,147,145,147],
        [126,126,125,215,209,210,125,23,196,200,200,200,200,200,201,208,208,208,146,145,146,145,146,145],
        [145,145,186,187,146,146,146,146,196,200,200,200,200,200,201,208,208,208,208,208,208,208,208,145],
        [126,215,209,210,216,146,146,146,223,226,226,226,221,226,226,226,226,226,226,226,226,226,228,145],
        [126,126,146,146,146,146,146,146,223,145,145,145,221,145,186,187,145,145,145,145,186,187,145,145],
        [145,145,146,146,146,146,146,146,223,145,146,145,221,216,209,210,215,145,145,216,209,210,145,145],
        [254,254,254,254,254,254,254,254,241,242,242,242,246,254,254,254,254,254,254,254,254,254,254,254],
        [288,288,282,270,258,259,260,276,276,282,262,263,264,265,266,267,268,269,270,271,272,273,274,275],
        [285,287,285,287,285,287,285,287,285,287,285,287,285,287,285,287,285,287,285,287,285,287,285,287],
        [287,285,287,285,287,285,287,285,287,285,287,285,287,285,287,285,287,285,287,285,287,285,287,287]
    ],
    "blocked": [ 
        1
    ],
    "inaccessible": [ 
        { 
            "topLeft": { "row": 0, "col": 0 },
            "bottomRight": { "row": 0, "col": 0 }
        }
    ]
}