{   
    "1": 
    {
        "uniqueTiles":519,
        "columns":23,
        "rows":9,
        "grid": [
            [0,1,2,2,2,3,4,5,5,5,6,7,7,7,8,7,7,7,9,10,11,12,46,46],
            [60,61,62,62,62,63,64,65,66,67,68,72,69,70,71,72,72,72,73,74,75,76,77,77],
            [136,137,138,139,140,141,142,143,144,145,146,147,148,149,150,151,152,153,154,155,156,157,158,159],
            [229,230,231,232,233,234,235,236,237,238,239,242,242,242,240,241,242,242,243,244,245,246,247,248],
            [310,311,312,311,312,313,314,315,316,317,318,311,312,311,319,320,312,311,312,311,132,321,132,311],
            ["E",371,370,343,347,371,370,371,370,371,370,345,370,371,370,371,370,371,370,346,347,371,370,371],
            [374,407,406,384,378,407,379,380,"E",407,406,381,382,407,383,407,406,407,406,384,385,386,406,407],
            ["E",450,417,450,449,418,419,420,421,450,449,422,423,450,449,450,449,450,449,450,449,450,449,450],
            [309,309,468,309,455,456,457,309,309,309,458,459,460,461,462,463,464,465,466,309,487,309,309,309],
            [309,509,309,309,309,309,309,309,309,510,309,309,511,309,309,309,309,309,309,309,309,309,309,309]
        ]       
    },


    "2": 
    {
        "uniqueTiles": 519,
        "columns": 23,
        "rows": 9,
        "grid": [
            [46,47,46,163,16,17,44,44,19,20,53,53,22,52,53,53,53,53,54,55,26,27,28,29],
            [77,77,77,78,79,80,81,81,82,169,170,170,84,85,170,170,170,170,130,131,89,90,91,92],
            [160,161,162,163,164,165,166,167,168,169,170,171,172,173,174,175,176,177,224,371,370,371,372,182],
            [248,248,249,250,251,252,253,254,255,256,264,258,259,260,261,262,263,264,304,305,406,407,308,309],
            [322,311,312,311,132,311,132,311,132,311,null,323,324,340,312,311,312,311,312,311,132,311,341,327],
            [370,371,348,371,370,371,370,349,350,351,352,371,368,369,370,371,370,371,370,371,370,371,372,373],
            [406,407,406,407,406,407,406,387,388,389,390,407,391,407,406,407,406,392,406,407,393,407,394,395],
            [449,450,449,450,449,443,444,450,449,450,449,450,449,450,449,448,449,427,449,429,430,450,432,309],
            [309,309,309,309,468,309,469,470,471,472,309,494,309,309,495,475,476,477,309,499,309,500,309,309],
            [309,512,309,309,309,309,309,513,309,309,309,309,309,309,309,309,309,309,514,515,516,309,309,309]
        ]        
    },

    "3":
    {
        "uniqueTiles": 519,
        "columns": 23,
        "rows": 9,
        "grid": [
            [30,31,32,33,34,35,36,37,38,39,40,41,41,41,42,43,44,44,44,44,44,45,46,46],
            [93,94,95,96,97,98,99,100,101,102,103,null,null,null,104,105,106,107,108,109,110,111,112,113],
            [309,309,184,185,186,187,188,189,190,191,192,193,194,195,196,197,198,199,200,201,202,203,204,205],
            [309,309,309,270,282,272,273,274,275,276,277,278,278,278,279,280,282,281,282,283,284,285,286,287],
            [309,309,309,328,329,35,330,331,332,333,334,35,332,35,332,35,332,35,332,35,332,35,332,35],
            [309,309,309,270,282,281,282,281,282,281,359,360,282,361,362,363,364,281,282,281,282,281,282,281],
            [309,309,396,397,398,35,332,35,332,35,332,35,399,400,401,402,332,403,332,35,332,404,405,35],
            [309,309,309,433,434,null,null,null,null,null,441,440,435,436,null,null,null,437,null,null,null,438,439],
            [309,309,309,480,481,309,309,309,309,309,482,309,309,483,484,485,486,309,309,309,487,309,500,309],
            [309,509,309,309,309,309,309,309,309,510,309,309,511,309,309,309,309,309,309,309,309,309,309,309]
        ]
    },

    "4":
    {
        "uniqueTiles":519,
        "columns":23,
        "rows":9,
        "grid": [
            [46,47,46,163,49,49,49,49,49,49,50,49,51,52,53,53,53,53,54,55,56,165,58,59],
            [114,115,116,117,118,119,120,121,122,123,123,123,124,125,126,127,128,170,130,131,132,133,134,135],
            [206,207,208,209,210,211,212,213,214,215,216,217,218,219,220,221,222,223,224,371,370,371,372,228],
            [288,289,290,291,292,293,293,293,294,295,296,297,298,299,300,301,302,303,304,305,406,407,308,309],
            [332,35,332,335,312,311,312,311,312,336,337,338,339,340,312,311,312,311,312,311,132,311,341,342],
            [282,281,282,365,370,371,370,366,367,371,370,371,368,369,370,371,370,371,370,371,370,371,372,373],
            [332,35,332,335,406,407,406,408,409,410,411,412,413,407,406,407,406,407,406,407,406,414,415,416],
            [441,440,441,442,449,443,444,450,449,445,446,447,449,450,449,448,449,450,449,450,451,452,453,309],
            [309,489,490,491,492,309,309,309,309,500,309,494,309,309,495,496,497,498,309,499,309,500,309,309],
            [309,512,309,309,309,309,309,513,309,309,309,309,309,309,309,309,309,309,514,515,516,309,309,309]
        ]
    }

}
