{
    "rows": 11,
    "battleMap": true,
    "music": "game-jam-4.mp3",
    "columns": 23,
    "uniqueTiles": 259,
    "grid": [
        [  2,  3,  1,  1, 12, 13, 14, 15,  1,  1, 14, 15, 14, 15,  1,  1, 14, 15, 12, 13,  1,  1,  2,  3],
        [  6,  7,  4,  5, 16, 17, 18, 19,  5,  5, 18, 19, 18, 19,  5,  5, 18, 19, 16, 17,  5,  5,  6,  7],
        [ 92, 65, 66,  9, 28, 29, 70, 70, 70, 70, 70, 70, 70, 70, 70, 70,198,198, 30, 31,162,  9,162, 91],
        [ 96, 70, 70, 70, 32, 33, 66, 66, 66, 66, 66, 66, 66, 66, 66, 66, 66, 66, 34, 35, 70, 70, 70, 95],
        [100, 65, 65, 65, 69, 69, 69, 69, 69, 69, 69, 69, 69, 69, 69, 69, 69, 69, 69, 69, 81, 81, 81, 99],
        [104, 70, 70, 70, 65, 65, 65, 65, 65, 65, 65, 65, 65, 65, 65, 65, 65, 65, 65, 65, 70, 70, 70,103],
        [108, 65, 65, 65, 69, 69, 69, 69, 69, 69, 69, 69, 69, 69, 69, 69, 69, 69, 69, 69, 81, 81, 81,107],
        [112, 70, 70, 70, 66, 66, 66, 66, 66, 66, 66, 66, 66, 66,259, 66, 66, 66, 66, 66, 70, 70, 70,111],
        [248,249,248,249,236,237,236,237,198,198,236,237,236,237,198,198,236,237,236,237,248,249,248,249],
        [240,241,230,231,240,241,252,253,255,246,252,253,252,253,255,246,252,253,252,253,230,231,252,253],
        [ 53,174,234,235, 21, 20, 70, 70,174,174, 22, 23, 26, 27,174,174,174,174, 20, 21,234,235,174, 54],
        [ 57,194,194,194,194,194,194,194,194,194,194,194,194,194,194,194,194,194,194,194,194,194,194, 50]
    ],
    "mapName": "battle-maps/battle_map1.json",
    "src":"Generic_Mart_Tile_Set.png"
}