{
    "src": "Generic_Room_B_Tile_Set/Generic_Room_B_Tile_Set.png",
    "uniqueTiles": 112,
    "blocked": [
        0, 1, 2, 3, 10, 11, 16, 17, 18, 19,
        24, 25, 32, 34, 35, 36, 37, 38, 39,
        41, 44, 45, 46, 47, 48, 49, 51, 53, 
        54, 55, 56, 57, 58, 59, 61, 63, 64, 
        65, 66, 67, 68, 69, 70, 71, 72, 73, 
        74, 75, 76, 77, 78, 79, 80, 81 
    ]
}